 --- --- --- --- --- --- --- --- --- 
|       |                           |
                     ---         --- 
|           |   |           |       |
     --- --- --- --- ---             
|               |       |           |
         ---         ---             
|                   |       |   |   |
     ---             ---             
|               |       |         < |
 --- --- --- --- --- --- --- --- --- 