 --- --- --- --- --- --- --- --- --- 
| >         |                       |
 --- ---                             
|           |           |           |
 ---     ---     --- --- --- ---     
|       |       |       |           |
     ---                             
|       |       |       |           |
                                     
|               |                   |
 --- --- --- --- --- --- --- --- --- 